                                                                
                                                               X
                                                               X
                                                    XXX        X
                                                               XXXX
                                                               X   X
         X                                                XXXXXX    X
         XXXXXXXXXX                                                  XXXXXXXXXXXXXXXXXXXXXX
                                                    XXX                                   X
                                                                                          X
                                          XXXX                                            X
                      P                                                                   X
                 XXXXXX                                                                   X
                             X                     XXXXX                                  X
S                                                              XXXXXXX                    X
X                                                              X     X                    X
X                                             X             XXXX     X                    X
X                                                              X     XXXXXXXXXXXXXXXXXXXXXX
X                    X          XXXXX                          X                          X
X     X                                                                      S            X
X                                                                                         X
X                                    X                                                    X
X                                    X                                                    X
XXXXXXXXXXXXXXXXXXXXXXXXXXXXXXXXXXXXXXXXXXXXXXXXXX         XXXXXXXXXXXXXXXXXXXXXXXXXXXXXXXX
X                                                X         X
X                                                X       XXX
X                                               SX         X                                     
X                                               XX         X                                     
X                                                X         X                                     
X           XXXX  XXXX XXXX  XXXXXXXXX           XXX       X                                     
X                                                X         X                                     X
X                                                X         X                                     X
X                                                X       XXXXXXXXXXXXXXXXXXXXXXXXXXXXXXXXXXXX    X
X                                                X                                          X    X
X                                                X                                          X    X
X  X   X                            XXXXXX       X                                          X    X
X  X   X                           X             X                                     S    X    X
X  X   X                          X              XXXXXXXXXXXXXXXXXXXXXXXXXXXXXXXXXXXXXXXXXXXX    X
X  X   X                         X                                                               X
X  X   X                        X                                                                X
X  X C X                      SX                                                                 X
XXXXXXXXXXXXXXXX              XXXXXXXXXXXXXXXXXXXXXXXXXXXXXXXXXXXXXXXXXXXXXXXXXXXXXXXXXXXXXXXXXXXX


